NO ./xpm/orange.xpm
WE ./xpm/greentile.xpm
SO ./xpm/lava.xpm
EA ./xpm/greenlava.xpm

C 119,65,10
F 25,51,0

111111111111111111111111111111111111111111111111111111111111
100000000000000000000000000000000000000000000000000000111111
100000111110000000000000000000000000000000000000000000000001
100000000000000000000000000000000000000000000000000000111111
100000000000000000000111100000000000000000000000000000000011
100000000000000000000000000000000000000000000000000000111111
100000000000000000000000000000000000000000000000000000111111
100000000000000000000000000000000111111000000000000000000001
100000000000000000000000000000000000000000000000000000111111
100000000000011100000000000000000000000111000000000000000001
10000000000001 100000000000000000000000000000000000000000111
100000000000011100000000000000000000000000000000000000001111
100000000000000000000000000000000000000000000000000000111111
100000000000000000000000000111110000000000000000000000000001
100000000000000000000000000000000000000000000000000000111111
100000000000000000000000000000000000000000000000000000111111
100000000000000000000000000000000000000000000000000000111111
100000000000000000000000000000000000000000000000000000111111
100000000000000000000000000000000000000000000000000000111111
100000001110000000000000000000000000000000000000000000000111
1000000001111110000000000000000000000000W0000000000000000001
100000000000000000000000000000000000000000000000000000111111
100000000000000000000000000000001110000000000000000000000111
100000000000000000000000000000111100000000000000000000000011
100000000000000000000000000000000000000000000000000000111111
100000000000000000000000000000000000000000000000000000111111
1000000000000000000000000000000000000000000000000000001
1111111111111111111111111111111111111111111111111111111
