NO ./xpm/colors13.xpm
WE ./xpm/colors15.xpm
SO ./xpm/colors16.xpm
EA ./xpm/colors14.xpm 

F 1,1,21
C 2,2,38

111111111111111111111111111111111
101010100000000101010000000001011
101010100000000000000000000000001
101010101010100000000101011011001
11000000000000000W000000000000001
111111111111111111111111111111111
