NO ./xpm/darkblue.xpm
WE ./xpm/greentile.xpm
SO ./xpm/grey.xpm
EA ./xpm/brown.xpm

F 65,60,65
C 100,149,237

111111111111111
100000000000001
100000000000001
100000000000001
100000000000001
100000000000001
100000000000001
1010000W0000101
100000000000001
100000000000001
100000000000001
100000000000001
100000010000001
100000000000001
111111111111111
